11111111
1P000001
100C0001
1C000001
10000001
1C0000C1
1E000001
11111111
