111111111111
1P000000C001
101111110101
101000010101
10100C010101
101000010101
10110101C101
100000000101
111111110101
1E0000000001
111111111111
