11111111111
1C00P0000C1
1E111011101
10111011101
1000E0000C1
1C11C111101
10C00111101
1CE0C0000C1
11111111111
