1111111111
1P00000001
10001C0001
1000100001
100010C001
10001000E1
1111111111
