1111111111
1P00000001
1000100001
1000100001
10C010C001
10001000E1
1111111111
