1111111111111
1P0C000000001
10001000000E1
1C10000000001
1111111111111
