1111111
1P0000C1
1000001
1000C01
1E00001
1111111
